1111111111111111111111111111111111
1E000000000100000000000C0000000001
1010110100110100010010000000101001
1010110100110100010010000000101001
1P0000000C00C0000000000000000001C1
1111111111111111111111111111111111