1111111111111111111111111111111111
1E000000000101000000000C0000000001
1010110100110100010010000000101001
1010110100000000010010000000101001
1P0000000C01C0000000000000000001C1
1111111111111111111111111111111111