1111111111111111111111
1010001111101110101111
1010101111111111111011
10000001P0000000000111
1011101001111010111011
1111111011101010001011
1000111011111010111011
1010101011111110101011
1110111010001010111011
1000C000101010000000E1
1110111010001010111011
1110111010001010111011
1110111010001010111011
1110111010001010111011
1110111010001010111011
1110111010001010111011
1111111111111111111111